"filename", "language", "C++", "comment", "blank", "total"
"d:\Proyectos de Programación\CaelisChaos\Caelis Chaos\src\Caelis Chaos.cpp", "C++", 307, 12, 42, 361
"d:\Proyectos de Programación\CaelisChaos\Caelis Chaos\src\TobiGameEngine\GUI\Button.cpp", "C++", 7, 0, 7, 14
"d:\Proyectos de Programación\CaelisChaos\Caelis Chaos\src\TobiGameEngine\GUI\Button.h", "C++", 2, 0, 2, 4
"d:\Proyectos de Programación\CaelisChaos\Caelis Chaos\src\TobiGameEngine\GUI\ListUI.cpp", "C++", 8, 0, 2, 10
"d:\Proyectos de Programación\CaelisChaos\Caelis Chaos\src\TobiGameEngine\GUI\ListUI.h", "C++", 2, 0, 1, 3
"d:\Proyectos de Programación\CaelisChaos\Caelis Chaos\src\TobiGameEngine\GUI\Menu.cpp", "C++", 9, 3, 6, 18
"d:\Proyectos de Programación\CaelisChaos\Caelis Chaos\src\TobiGameEngine\GUI\Menu.h", "C++", 2, 0, 2, 4
"d:\Proyectos de Programación\CaelisChaos\Caelis Chaos\src\TobiGameEngine\RTS-utilities\Building.h", "C++", 1, 0, 0, 1
"d:\Proyectos de Programación\CaelisChaos\Caelis Chaos\src\TobiGameEngine\RTS-utilities\Entity.cpp", "C++", 4, 0, 1, 5
"d:\Proyectos de Programación\CaelisChaos\Caelis Chaos\src\TobiGameEngine\RTS-utilities\Entity.h", "C++", 1, 0, 1, 2
"d:\Proyectos de Programación\CaelisChaos\Caelis Chaos\src\TobiGameEngine\RTS-utilities\Player.cpp", "C++", 8, 0, 1, 9
"d:\Proyectos de Programación\CaelisChaos\Caelis Chaos\src\TobiGameEngine\RTS-utilities\Unit.cpp", "C++", 16, 0, 3, 19
"d:\Proyectos de Programación\CaelisChaos\Caelis Chaos\src\TobiGameEngine\RTS-utilities\Unit.h", "C++", 1, 0, 0, 1
"d:\Proyectos de Programación\CaelisChaos\Caelis Chaos\src\TobiGameEngine\TobiGameEngine.h", "C++", 24, 1, 7, 32
"Total", "-", 392, 16, 75, 483