"filename", "language", "C++", "comment", "blank", "total"
"d:\Proyectos de Programación\CaelisChaos\Caelis Chaos\src\Caelis Chaos.cpp", "C++", 2240, 149, 436, 2825
"d:\Proyectos de Programación\CaelisChaos\Caelis Chaos\src\TobiGameEngine\GUI\Button.cpp", "C++", 94, 10, 16, 120
"d:\Proyectos de Programación\CaelisChaos\Caelis Chaos\src\TobiGameEngine\GUI\Button.h", "C++", 33, 5, 19, 57
"d:\Proyectos de Programación\CaelisChaos\Caelis Chaos\src\TobiGameEngine\LTexture.cpp", "C++", 181, 36, 39, 256
"d:\Proyectos de Programación\CaelisChaos\Caelis Chaos\src\TobiGameEngine\LTexture.h", "C++", 39, 18, 23, 80
"d:\Proyectos de Programación\CaelisChaos\Caelis Chaos\src\TobiGameEngine\LTimer.cpp", "C++", 64, 21, 18, 103
"d:\Proyectos de Programación\CaelisChaos\Caelis Chaos\src\TobiGameEngine\LTimer.h", "C++", 21, 7, 9, 37
"d:\Proyectos de Programación\CaelisChaos\Caelis Chaos\src\TobiGameEngine\RTS-utilities\Building.cpp", "C++", 118, 0, 21, 139
"d:\Proyectos de Programación\CaelisChaos\Caelis Chaos\src\TobiGameEngine\RTS-utilities\Building.h", "C++", 44, 0, 23, 67
"d:\Proyectos de Programación\CaelisChaos\Caelis Chaos\src\TobiGameEngine\RTS-utilities\Entity.cpp", "C++", 70, 0, 17, 87
"d:\Proyectos de Programación\CaelisChaos\Caelis Chaos\src\TobiGameEngine\RTS-utilities\Entity.h", "C++", 36, 0, 21, 57
"d:\Proyectos de Programación\CaelisChaos\Caelis Chaos\src\TobiGameEngine\RTS-utilities\Player.cpp", "C++", 97, 0, 27, 124
"d:\Proyectos de Programación\CaelisChaos\Caelis Chaos\src\TobiGameEngine\RTS-utilities\Player.h", "C++", 53, 1, 26, 80
"d:\Proyectos de Programación\CaelisChaos\Caelis Chaos\src\TobiGameEngine\RTS-utilities\Projectile.cpp", "C++", 19, 0, 4, 23
"d:\Proyectos de Programación\CaelisChaos\Caelis Chaos\src\TobiGameEngine\RTS-utilities\Projectile.h", "C++", 18, 0, 12, 30
"d:\Proyectos de Programación\CaelisChaos\Caelis Chaos\src\TobiGameEngine\RTS-utilities\Sprite.cpp", "C++", 12, 0, 2, 14
"d:\Proyectos de Programación\CaelisChaos\Caelis Chaos\src\TobiGameEngine\RTS-utilities\Sprite.h", "C++", 12, 0, 5, 17
"d:\Proyectos de Programación\CaelisChaos\Caelis Chaos\src\TobiGameEngine\RTS-utilities\Unit.cpp", "C++", 117, 0, 21, 138
"d:\Proyectos de Programación\CaelisChaos\Caelis Chaos\src\TobiGameEngine\RTS-utilities\Unit.h", "C++", 48, 0, 30, 78
"d:\Proyectos de Programación\CaelisChaos\Caelis Chaos\src\TobiGameEngine\TobiGameEngine.h", "C++", 417, 34, 110, 561
"Total", "-", 3733, 281, 879, 4893